¡é¡æ¡æ¡æ¡æ¡æ¡æ¡æ¡æ¡é
¡æ¡æ¡æ¡æ¡æ¡æ¡æ¡æ¡æ¡é
¡æ¡æ¡æ¡æ¡æ¡æ¡æ¡é¡æ¡é
¡æ¡æ¡æ¡æ¡æ¡æ¡æ¡è¡æ¡é
¡æ¡æ¡æ¡æ¡æ¡æ¡è¡é¡ç¡ç
¡æ¡æ¡æ¡æ¡æ¡è¡è¡é¡ç¡è
¡æ¡é¡æ¡æ¡è¡è¡è¡è¡è¡ç
