¡ç¢×¡é¢Ø¡æ¡æ¡æ¡æ¡æ¡é
¢Ù¢Ù¡é¢×¢Ù¢Ù¡æ¡æ¢Ù¡é
¡æ¢Ù¡é¢×¢×¡æ¡æ¢Ù¢Ù¢×
¡æ¡æ¢Ù¢×¢×¢Ù¢Ù¡è¢×¡ç
¡æ¡æ¡æ¢Ù¢Ù¢Ù¢Ù¡é¡ç¡ç
¢Ù¡æ¡æ¡æ¡æ¡æ¡æ¡é¢Ö¢×
¢Ö¢Ö¡æ¡æ¡æ¢Ù¢Ö¡è¡è¢Ö
